abastecer a alguien de (o: con) algo|jmdn. mit etw. versorgen|Verb
ablandarse<br/>ablandar algo|weich werden<br/>etw. durchweichen, etw. erweichen|Verb
el abono|das Abonnement|Subst
aborrecer algo/a alguien|jmdn. hassen, jmdn./etw. verabscheuen|Verb
abrasador/-a|brennend, glühend, sengend|Adj
absorto/-a|versonnen, andächtig|Adj
abstenerse<br/>abstenerse de algo|sich enthalten<br/>auf etw. verzichten|Verb
acaparar algo|etw. aufkaufen, etw. hamstern<br/>etw. beanspruchen|Verb
acarrear algo<br/>acarrear algo (agr., cosecha)|etw. transportieren<br/>etw. einfahren|Verb
accidental<br/>accidentalmente|zufällig<br/>unabsichtich, versehentlich|Adj, Adv
acertado/-a|treffend, richtig, ratsam|Adj
acitronar la cebolla|Zwiebeln glasig dünsten|Verb
acomodar algo/a alguien<br/>acomodarse a algo|etw. in Ordnung bringen<br/>sich auf etw. einstellen|Verb
acontecer (form.)|geschehen, sich ereignen|Verb
acontecer (form.)<br/>acontecido/-a (cara o rostro)|geschehen, vorkommen, vorfallen<br/>betrübt, traurig|Verb, Adj
la acrimonia (form.)|die Schärfe|Subst
adentrarse en algo|in etw. hineingehen, in etw. eindringen, etw. durchdringen|Verb
adueñarse de algo|sich etw. aneignen, sich jmds./etw. bemächtigen|Verb
aferrarse a algo/a alguien|sich an jmdn./etw. klammern|Verb
afianzar algo|für etw. bürgen, etw. bekräftigen, etw. festigen|Verb
aflojar|abflauen, etw. auflockern|Verb
agasajar algo/a alguien|für jmds./etw. Wohlergehen sorgen, jmdn./etw. gut bewirten|Verb
agraciado/-a|anmutig, begünstigt, auserwählt|Adj
el agrado<br/>agradar a alguien|die Freundlichkeit<br/>jmdm. gefallen, jmdm. behagen|Subst, Verb
agregar algo|etw. hinzufügen, etw. ergänzen|Verb
el aguardiente|der Branntwein|Subst
la agudeza|die Grelle, die Schärfe, die Bauernschläue|Subst
agudizarse<br/>agudizar algo|sich verschärfen<br/>etw. verschärfen|Verb
agusanarse|madig werde, wurmstichig werden|Verb
ahuyentar algo/a alguien|jmdn./etw. verjagen, jmdn./etw. verscheuchen|Verb
el ajonjolí (bot.)|der Sesam|Subst
el ajuar|die Aussteuer, der Hausrat|Subst
el álamo|die Pappel|Subst
el albor|die Morgendämmerung|Subst
el alcanfor|der Kampfer|Subst
álgido/-a|eisig|Adj
almidonado/-a|gestärkt, geschniegelt|Adj
alterarse<br/>alterar algo|sich beunruhigen, sich (über etw.) aufregen<br/>etw. abändern, etw. verändern|Verb
el alumbramiento|die Entbindung|Subst
amamantar a alguien|jmdn. stillen, jmdn. saugen|Verb
amargar|bitter schmecken|Verb
amarrar algo<br/>amarrar algo a algo|etw. festbinden<br/>etw. an etw. festmachen|Verb
amasar algo|etw. kneten, etw. anmachen|Verb
amedrentarse|sich erschrecken, sich ängstigen|Verb
ameritar algo (Lat. Am.)|etw. verdienen, etw. auszeichnen|Verb
amigable|freundlich, gütlich|Adj
aminorar algo|etw. mindern, etw. verlangsamen|Verb
anexar algo|etw. annektieren, etw. einverleiben|Verb
angelical|engelhaft|Adj
angosto/-a<br/>angostar algo|eng<br/>etw. verengen|Adj, Verb
anhelar algo|etw. ersehnen, nach etw. lechzen|Verb
el anhelo|die Begierde, die Sehnsucht, der Herzenswunsch|Subst
el animalejo|das Tierchen|Subst
de antemano|im Voraus, vorneweg|Adj
la anticipación|der Vorgriff, die Vorverlegeung|Subst
anticipar algo|etw. vorausschicken etw. vorgreifen, etw. vorwegnehmen|Verb
el antojo|die Laune, das Belieben|Subst
el antro|der Abgrund, die berüchtige Bar, die Bude|Subst
apacible|ruhig sanft, beschaulich|Adj
el apagón|der Stromausfall, der Blackout|Subst
el aparador|die Anrichte, das Sideboard|Subst
aparentar algo|etw. vorspielen, etw. vorgeben, etw. zur Schau tragen|Verb
aparente|anscheinend, ersichtlich|Adj
aparentemente|anscheinend, scheinbar|Adv
apenar a alguien<br/>apenarse por algo/alguien|jmdn. bekümmern<br/>sich um jmdn./etw. sorgen|Verb
aplacar algo/a alguien|jmdn./etw. beruhigen, jmdn./etw. besänftigen|Verb
el aplomo|der Ernst, die Sicheheit, sicheres Auftreten, die Souveränität|Subst
apremiante|bedrückend, dringend, dringlich|Adj
apretar algo|etw. andrücken, etw. festklemmen, etw. herunterdrücken|Verb
apropiad/-a|geeignet, maßgeschneidert, tauglich|Adj
apurado/-a|sorgfältig, erschöpft, in einer heiklen Lage|Adj
el apuro|der Gram, der Kummer, unangenehme Lage|Subst
el armadillo (zool.)|das Gürteltier|Subst
arqueado/-a|gebogen, gekrümmt|Adj
arrasar algo|etw. einebnen, etw. abreißen, etw. zerstören, etw. ausradieren|Verb
arrebatarse<br/>arrebatar algo a alguien|wütend werden, außer sich geraten<br/>jmdm. etw. entreißen, jmdn. mitreißen|Verb
arremolinarse|sich zusammendrängen, sich zusammenscharen|Verb
el arribo<br/>arribar|die Ankunft<br/>landen, ankommen|Subst, Verb
arropar algo/a alguien<br/>arroparse|jmdn./etw. bedecken<br/>sich zudecken|Verb
la aspereza|die Herbe, die Rauheit|Subst
la aspiración|das Saugen, das Streben|Subst
el astro|das Gestirn|Subst
asumir algo|etw. annehmen, etw. übernehmen, etw. verkraften|Verb
atemorizarse|sich ängstigen, sich erschrecken|Verb
atenuar algo|etw. mildern, etw. abschwächen|Verb
la atole|warmes Getränk aus Maismehl und Milch oder Wasser|Subst
atorarse|stocken, stecken bleiben, verstopfen|Verb
atormentarse|sich quälen|Verb
atraído/-a|angezogen|Adj
atrasado/-a|spät, nächträglich, rückständig|Adj
el atraso|der Zeitrückstand, die Verspätung, der Rückstand|Subst
atropelladamente|überstürzt|Adv
aunar algo|etw. verbinden, etw. vereinen|Verb
la avena (bot.)|der Hafer|Subst
el aventón|die Mitnahme im Auto|Subst
averiar algo<br/>averiarse<br/>averiado/-a|etw. beschädigen<br/>havarieren<br/>fehlerhaft|Verb, Adj
el azahar|die Orangenblüte|Subst
azorar algo/a alguien|jmdn./etw. ängstigen, jmdn./etw. erschrecken|Verb
el azumbre|Flüssigkeitsmaß von rund zwei Litern|Subst
añorar algo/a alguien|jmdn./etw. sehnlichst verlangen, sich nach jmdm./etw. sehnen|Verb
la bacinica|der Nachttopf|Subst
la bala|der Ballen, die Gewehrkugel|Subst
la balacera (Lat. Am. )|die Schießerei|Subst
el balde<br/>de balde|der Kübel, der Eimer<br/>gratis, kostenlos, unentgeltlich|Subst, Adj
bambolear algo/a alguien|jmdn./etw. schaukeln, jmdn./etw. schwingen|Verb
barnizar algo|etw. beizen, etw. lackieren, etw. lasieren, etw. glasieren|Verb
barrer algo|etw. fegen, etw. kehren|Verb
la bayeta|der Aufwischlappen, der Putzlappen|Subst
bendecir algo/a alguien|jmdn./etw. segnen, jmdn./etw. weihen|Verb
la bengal|die Leuchtrakete, die Wunderkerze|Subst
la bicoca|die Lappalie, die Belanglosigkeit|Subst
el bizcocho (kulin.)<br/>el bizcocho|der Biskuit<br/>der Sandkuchen, der Rührkuchen|Subst
la blancura|die Weiße|Subst
la bola|die Kugel|Subst
la bondad|die Güte, die Gutherzigkeit|Subst
el borbotón|das Sprudeln|Subst
bordar (algo)|(etw.) sticken|Verb
borroso/-a|trübe, unscharf|Adj
brincar|hopsen, hüpfen|Verb
el bronquio (anat.)|die Bronchie|Subst
brotar|quellen, sprudeln, aufspritzen|Verb
el buche<br/>el buche (col.)<br/>el buche (zool.)|der Labmagen<br/>der Magen<br/>der Kropf|Subst
la bujía|die Kerze|Subst
el burdel|das Bordell|Subst
el buró<br/>el buró (Lat. am.)|der Schreibtisch<br/>der Nachttisch|Subst
el buró<br/>el buró (Lat. Am.: Méx.)|der Schreibtisch<br/>der Nachttisch|Subst
el caballerango|der Stallbursche|Subst
cadencioso/-a|rhythmisch, harmonisch, wolhlklingend|Adj
la cal|der Kalk|Subst
calcinar algo (campos, plantas, etc.)<br/>calcinar algo (chem.)|etw. abbrennen<br/>etw. verkohlen|Verb
el calvario (fig.)|die Qual|Subst
el camote (Lat. Am.: Ecu., Fil., Méx., Perú) (bot., kulin.)|die Süßkartoffel|Subst
la canasta|der Korb|Subst
cándido/-a|arglos, naiv, unschuldig|Adj
la canícula|die Hitze, die Hundstage, die Sommerhitzt|Subst
el cántaro|der Krug, der Tonkrug|Subst
canturrear|(halblaut vor sich hin) trällern, vor sich hin singen|Verb
la capa|der Belag, die Schicht, der Überwurf, der Umhang|Subst
capar algo/a alguien<br/>capar algo (col., fig.)|jmdn./etw. einschränken, etw. beschneiden<br/>etw. kastrieren|Verb
capitanear algo/a alguien|jmdn./etw. anführen, jmdn. leiten|Verb
el carmín|das Karmin|Subst
el carnero|der Hammel|Subst
la carretela|die Kalesche mit Klappverdeck|Subst
el carruaje|die Kutsche|Subst
el cascarón|die Eierschale|Subst
casto/-a|keusch|Adj
castrar a alguien|jmdn. entmannen, jmdn. kastrieren|Verb
la cataplasma (med.)|der Breiumschlag|Subst
la cátedra|der Lehrstuhl|Subast
la cavilación|der Kniff, das Nachdenken, die Grüblerei|Subst
el cazo|die Schöpfkelle, der Kochtopf|Subst
el cañonazo|der Kanonendonner, der Kanonenschlag|Subst
cebar algo|etw. beködern, etw. nähren, etw. auffüllen|Verb
el cebo|das Lockmittel, der Köder, das Mastfutter|Subst
la cecina|das Dörrfleisch, das Rauchfleisch|Subst
el cedazo|das Sieb|Subst
la ceguera|die Blindheit|Subst
el celador, la celadora|der Aufseher, die Aufseherin|Subst
cepillar algo|etw. bürsten|Verb
cerciorarse de algo|sich Gewissheit über etw. verschaffen, sich von etw. überzeugen|Verb
el cerillo (Esp.: And.; Lat. Am.: Méx.)|das Streichholz|Subst
la certeza|die Gewissheit|Subst
el chabacano (Lat. Am.: Méx. )|die Aprikose|Subst
la chambra|die Hausjacke|Subst
el champurrado|Mixgetränk mit Maisstärke und Schokolade|Subst
la chanza|der Scherz, der Witz|Subst
la charola (Lat. Am.)|das Tablett|Subst
el chicharrón (kulin.)<br/>chicharrón (col., persona)|knusprig gebratene Schweineschwarten<br/>stark sonnengebräunter Mensch|Subst
chillar|kreischen, quieken|Verb
chiqueador/-a|gekniffen|Adj
chiquear algo (mimar)|etw. verwöhnen|Verb
el chisguete|der Schluck|Subst
chueco/-a (Lat. Am.: Cuba, Méx.)|krumm, schief|Adj
cicatrizado/-a|narbig|Adj
el cisne (zool.)|der Schwan|Subst
el clavo|der Nagel, die Gewürznelke, die Nelke|Subst
la cobija (textil.) (Lat. Am. )|die Decke, die Bettwäsche|Subst
la cobija (Lat. Am. )|die Bettwäsche|Subst
cocer|sieden, etw. kochen, etw. backen|Verb
el cochero|der Kutscher|Subst
el cofre|die Truhe|Subst
la coladera|das Sieb, der Seiher|Subst
la colcha|die Tagesdecke|Subst
colgado/-a|aufgehängt|Adj
colindar con algo|an etw. grenzen|Verb
colmar algo|etw. überfüllen|Verb
el comal|flache, runde Kochplatte aus Ton|Subst
el comino (bot.)|der Kreuzkümmel|Subst
la compostura|der Anstand|Subst
el compromiso|die Verabredung, die Verpflichtung, die Verlobung|Subst
concluir algo|etw. vollenden|Subst
confeccionado/-a<br/>confeccionar algo|angefertigt<br/>etw. anfertigen, etw. herstellen|Adj, Verb
confiable|zuverlässig|Adj
la congelación|das Gefrieren, die Unterkühlung|Subst
la conmiseración|das Mitleid|Subst
conmover a alguien|jmdn. erschüttern, jmdn. rühren|Verb
el conocedor, la conocedora|der Kenner, die Kennerin|Subst
consabido/-a|alltäglich, bekannt, klassisch, üblich|Adj
consumar algo|etw. vollenden, etw. vollbringen, etw. vollziehen|Verb
el contador|der Buchhalter, der Gebührenzähler|Subst
contagiar a alguien<br/>contagiarse|jmdn. anstecken<br/>sich übertragen|Verb
contener algo|etw. zügeln, sich etw. verkneifen, etw. beherrschen|Verb
el contrabando|der Schmuggel|Subst
contraponer algo|etw. dagegenhalten, etw. entgegenstellen, etw. gegenüberstellen|Verb
contrarrestar algo|etw. aufhalten, etw. entgegenwirken, etw. eindämmen|Verb
la contratación|die Anstellung, die Neueinstellung|Subst
el contubernio|das Zusammenwohnen|Subst
convenir|angemessen sein, nutzlich sein|Verb
la convulsión|der Krampf|Subst
el cónyuge, la cónyuge|der Gatte, die Gattin|Subst
el copal|der Kopal (ein Baumharz)|Subst
copioso/-a|reichlich|Adj
la cordura|der Verstand|Subst
el corral|der Geflügelhof, der Hof|Subst
corretear|herumlaufen, herumtollen|Verb
el coscorrón|die Kopfnuss|Subst
el costal|das Querholz, der Sack|Subst
la costura (textil.)|das Nähen, die Naht|Subst
el costurero|der Nähkasten|Subst
el coto<br/>poner coto a algo/a alguien|das Gehege, das Revier<br/>jmdm./etw. Einhalt gebieten|Subst, Phrase
cuadrarse (milit.)|strammstehen|Verb
el cuartucho (ugs.) - vivienda o cuarto feo y pequeño|das Loch (Behausung)|Subst
el cuchicheo|das Getuschel|Subst
el cuestionamiento|das Infragestellen|Subst
culminar|in etw. gipfeln|Verb
curado/-a|trocken, ausgehärtet, gepökelt|Adj
dar jicarazo a algo|etw übereilt erledigen|Subst
la decencia|die Anständigkeit, der Anstand|Subst
la decocción|die Abkochung, der Absud|Subst
el dedal|der Fingerhut|Subst
deglutir algo|etw. schlucken, etw. hinunterschlingen|Verb
degollar algo/a alguien|jmdm./etw. die Kehle aufschneiden, jmdm./etw. enthaupten|Verb
el delantal|die Schürze|Subst
delinera algo|etw. zeichnen, etw. skizzieren|Verb
demoledor/-a|erschütternd, verheerend|Adj
el depósito (finan.)<br/>el depósito|die Anzahlung<br/>der Aufbewahrungsort|Subst
la deriva|die Kursabweichung, die Abdrift|Subst
derramar algo|etw. verbreiten, etw. vergießen|Verb
desabrigado/-a|ungeschützt|Adj
desalmado/-a|herzlos|Adj
desangrarse|verbluten, ausbluten|Verb
desbaratar algo|etw. zunichtemachen, etw. verschwenden, etw. durchbringen|Verb
desbocarse|ausfallend werden<br/>durchgehen|Verb
desbordar|überlaufen, überschwemmen|Verb
descascar algo|etw. schälen, etw. enthülsen|Verb
descomunal|ungeheuer, außerordentlich, ungemein|Adj
desconcertado/-a|ratlos, bestürzt, fassungslos, verblüfft, verwirrt|Adj
el desconcierto|die Bestürztheit, die Verwirrung, die Ratlosigkeit|Subst
la desdicha|das Elend|Subst
el desenfreno<br/>desenfrenarse<br/>desenfrenado/-a|die Hemmungslosigkeit, die Zügellosigkeit<br/>sich nicht zügeln<br/>hemmungslos, zügellos|Subst, Verb, Adj
desentrañar algo|etw. ergründen, etw. erfassen, etw. herausbekommen|Verb
desfallecer|ermatten, schwach werden, in Ohnmacht fallen|Verb
el desgarramiento|der Einriss, das Einreissen|Subst
desgarrar algo|etw. zerrißen, etw. zerfetzen|Verb
el desgarre<br/>desgarrar algo|der Riss<br/>etw. zerreißen, etw. zerfetzen|Verb
desgranar algo|etw. auskörnen, etw. aushülsen|Verb
deshojar algo|etw. entblättern, etw. entlauben|Verb
desistir de algo|auf etw. verzichten, von etw. ablassen, etw. aufgeben|Verb
desleírse<br/>desleír algo|sich auflösen, zergehen<br/>etw. anrühren, verrühren|Verb
deslizarse|ausrutschen, rutschen, herunterrutschen|Verb
deslumbrar algo/a alguien|jmdn./etw. blenden|Verb
desmadrar un animal|ein Tier von der Mutter trennen|Verb
desmandarse|sich widersetzen, ausfallend werden|Verb
desmantelar algo|etw. demontieren, etw. niederreißen, etw. abbauen|Verb
desmembrar algo|etw. aufteilen, etw. spalten, etw. trennen|Verb
desmembrar algo/a alguien|jmdn./etw. zergliedern, zerstückeln, zerlegen|Verb
desmesurado/-a|maßlos, übermäßig, unangemessen|Adj
la desobediencia|der Ungehorsam|Subst
desolar algo|etw. verheeren, etw. verwüsten|Verb
despedir a alguien<br/>despedir algo|jmdn. verabschieden, jmdn. entlassen, jmdn. kündigen<br/>etw. aussenden, etw. ausstrahlen, etw. ausströmen|Verb
despedirse de algo/alguien<br/>despedir algo|sich von jmdm./etw. verabschieden<br/>etw. aussenden, etw. ausstrahlen, etw. ausströmen|Verb
despejar algo|etw. abräumen, etw. entrümpeln, etw. frei machen|Verb
la despensa|die Speisekammer, die Vorratskammer|Subst
desperdigar algo|etw. verstreuen, etw. zerstreuen|Verb
despojar a alguien<br/>despojarse de algo|jmdn. ausplündern<br/>auf etw. verzichten, sich etw. entledigen, etw. abstreifen|Verb
desprenderse:desprender algo|absplittern, abbröckeln, sich ablösen<br/>etw. abgeben, etw. trennen, etw. losmachen|Verb
el destello|der Blitz, das Glitzern|Subst
destetar a alguien|jmdn. abstillen, jmdn. entwöhnen|Verb
la destreza|die Fingerfertigkeit, die Geschicklichkeit|Subst
desvenar (el chile)|Chilischoten putzen|Verb
el detonador|der Zünder, die Sprengkapsel|Subst
devorar algo|etw. auffressen, etw. verschlingen|Verb
difunto/-a|verstorben, tot|Adj
dignarse a hacer algo|geruhen etw. zu tun, sich herablassen etw. zu tun|Verb
el dije - colgante|der Anhänger - Schmuckstück|Subst
disociar algo<br/>disociarse|etw. abspalten<br/>zerfallen, sich auflösen|Verb
el disparo<br/>disparar|der Schuss<br/>abdrücken, schießen|Subst, Verb
disputarse algo|miteinander um etw. wetteifern|Verb
divino/-a|göttlich|Adj
doblegar algo|etw. biegen, beugen, krümmen|Verb
dondequiera|irgendwo, überall, wo immer|Adv
la duela|die Daube|Subst
la dulzura|die Warmherzigkeit, die Sanftheit|Subst
la ebullición|das Aufkochen, das Sieden, die Wallung|Subst
elogiar algo/a alguien|jmdn./etw. loben, anpreisen|Verb
emanar algo|etw. abgeben, etw. ausdünsten|Verb
embelesar a alguien|jmdn. bezaubern, jmdn. entzücken|Verb
el embudo|der Fülltrichter, der Trichter|Subst
el embuste|die Flunkerei|Subst
empacar algo|etw. etw. einpacken, etw. packen, etw. verpacken|Verb
empanizar algo|etwas panieren|Verb
el empeño<br/>empeñar a alguien a (o: para) algo<br/>empeñarse en algo|die Beharrung, das Bestreben<br/>jmdn. zu etw. verpflichten, jmdn. zu etw. zwingen<br/>auf etw. beharren, unbedingt etw. tun müssen|Subst, Verb
emplear algo<br/>emplear a alguien|etw. benutzen, etw. anwenden<br/>jmdn. beschäftigen|Verb
en vano|vergeblich, umsonst|Adj
la enagua|der Unterrock|Subst
enardecer|entfachen, erregen, begeistern|Verb
encargarse de algo/alguien|sich um jmdn./etw. kümmern, etw. übernehmen|Verb
encerar algo|etw. bohnern, etw. wachsen|Verb
encoger algo|etw. zusammenziehen|Verb
enderezarse<br/>enderezar algo|sich aufrichten<br/>etw. gerade biegen, etw. gerade machen|Verb
endurecerse|erstarren, sich erhärten, sich verhärten|Verb
enfatizar algo|etw. betonen|Verb
enfriarse|erkalten, sich abkühlen|Verb
enfurecerse<br/>enfurecer a alguien|in Wut geraten<br/>jmdn. wütend machen|Verb
enjuiciar algo/a alguien|jmdn./etw. beurteilen, jmdn./etw. bewerten|Verb
la enjundia|das Tierfett|Subst
enmohecido/-a|schimmelig|Adj
enmudecer|verstummen, verschweigen|Verb
entablar algo|etw. beginnen, etw. einleiten, etw. unternehmen|Verb
el entendedor, la entendedora|der Kenner|Subst
enternecerse|weich werden, gerührt werden|Verb
entibiarse<br/>entibiar algo|sich abkühlen, lau werden<br/>etw. lau machen, etw. abkühlen|Verb
las entrañas|die Eingeweide|Subst
entreabrir algo|etw. halb öffnen|Verb
envenenado/-a|vergiftet|Adj
envenenar algo/a alguien (auch fig.)|jmdn./etw. vergiften|Verb
el epazote (bot.)|Mexikanischer Drüsengänsefuß|Subst
erguirse<br/>erguir algo - brazo, etc.|sich aufrichten, sich erheben<br/>etw. hochhalten, etw. aufrecken, etw. heben|Verb
errante|irrend, verfehlend, ziellos|Adj
escoger algo/a alguien entre (o: de) algo/alguien|jmdn./etw. aus (oder: unter) jmdm./etw. auswählen, jmdn./etw. aus (oder: unter) jmdm./etw. aussuchen|Verb
la escolta|die Eskorte, das Geleit|Subst
a escondidas|heimlich|Adj
el escondrijo|der Schlupfwinkel, der Unterschlupf|Subst
escrutador/-a|forschend|Adj
escuálido/-a|verwahrlost, ausgemergelt, abgemagert|Adj
el escupitajo|die Spucke|Subst
escurrir|ablaufen, abtropfen|Verb
esfumarse|verschwimmen, verlaufen, verblassen, verduften|Verb
el eslabón|das Bindeglied, das Glied|Subst
esmerar algo<br/>esmerarse en algo|etw. putzen, etw. polieren<br/>sich um etw. bemühen, sich bei etw. (größte) Mühe geben|Verb
el esmero|die Sorgfalt|Subst
el esófago (anat.)|die Speiseröhre|Subst
espantadizo/-a|kopfscheu|Adj
espantoso/-a|entsetzlich, grässlich, traurig|Adj
esparcirse|sich verbreiten, sich verstreuen|Verb
el espectáculo de sombras chinas|das Schattenspiel|Subst
esplendoroso/-a|glanzvoll, leuchtend, strahlend|Adj
el espliego (bot.)|der Lavendel|Subst
la esponja|der Schwamm|Subst
el estacionamiento|das Parken, der Parkplatz, die Stationierung|Subst
el estambre|das Kammgarn|Subst
el estrago|die Verwüstung, die Zerstörung|Subst
el estremecimiento|das Frösteln, der Schauder|Subst
la estufa|der Ofen, die Ofenheizung|Subst
evaporarse|sich verflüchtigen, verdampfen, verdunsten|Verb
evocar algo|etw. hervorrufen, etw. ins Gedächtnis rufen|Verb
exasperarse<br/>exasperar a alguien|wütend werden, aufbrausen<br/>jmdn. in Wut versetzen|Verb
las exigencias|die Anforderungen, die Erfordernisse|Subst
extinguido/-a|ausgestorben|Adj
las facciones (de la cara)<br/>la facción (pol.)|die Gesichtszüge<br/>die Fraktion, die Parteigruppe|Subst
el faisán (zool.)|der Fasan|Subst
fajar a alguien|jmdn. umwickeln|Verb
el fajero|die Nabelbinde|Subst
la fécula|das Stärkemehl, die Stärke|Subst
felicitar a alguien por algo<br/>felicitarse de algo|jmdm. zu etw. gratulieren<br/> sich über etw. freuen|Verb
el felino (zool.)|die Katze|Subst
la felpa (textil.)|der Plüsch|Subst
flojo/-a|lasch, schlapp|Adj
la fogata|das Lagerfeuer, das Freudenfeuer|Subst
fogoso/-a|Feuer ..., hitzig, ungestüm|Adj
forzar algo|etw. erzwingen, etw. forcieren|Verb
la fragancia|der Wohlgeruch, der Duft|Subst
franco/-a|aufrichtig, offenherzig, freigebig|Adj
la franela|das Flanelltuch|Subst
el frasco|das Vorratsglas, das Einmachglas|Subst
el fregadero|der Ausguss, das Spülbecken|Subst
fregar algo|etw. wischen, schrubben abspülen|Verb
el frenesí|der Taumel, das Ungestüm, die Raserei|Subst
el fulgor|das Blitzen, das Funkeln|Subst
la fumarola (geol.)|vulkanische Dampfquelle|Subst
fundirse|schmelzen, zerfließen|Verb
fusilar algo<br/>fusilar a alguien|etw. (schlecht) nachahmen, etw. plagiieren<br/>jmdn. standrechtlich erschießen, jmdn. niederschießen|Verb
galopar|galoppieren|Verb
el gancho|der Haken|Subst
garrafal|großfrüchtig, riesig, ungeheuer|Adj
el gatillo|der Abzug, der Hahn, der Drücker|Subst
gélido/-a|eiskalt, gefroren|Adj
el glóbulo|das Blutkörperchen, das Kügelchen|Subst
el glúteo|das Gesäß|Subst
la gordura|die Korpulenz, die Fettheit|Subst
el gozo|die Freude, die Wonne|Subst
el grado|die Stufe, der Rang|Subst
el granero|die Scheune, der Getreidespeicher|Subst
la grieta|der Spalt, der Riss|Subst
el guajolote (Lat. Am.: Hond., Méx.)|der Truthahn|Subst
el guiso|das Gericht, das Geschmorte|Subst
la gula|die Völlerei|Subst
el gusano (zool.)|der Wurm, die Made|Subst
la hazaña|die Heldentat, der Kraftakt, das Wagnis|Subst
la hebra|der Faden|Subst
el hechizo<br/>hechizar a alguien|der Zauber<br/>jmdn. bezaubern|Subst, Verb
la hemorragia (med.)|der Blutfluss, die Blutung|Subst
la hendidura|der Spalt, die Kerbe|Subst
herir algo/a alguien|jmdn./etw. verletzen, jmdn./etw. verwunden|Verb
el hervor|das Aufkochen, die Aufwallung|Subst
la hiel<br/>jabón de hiel (de buey)|die Galle<br/>die Gallseife|Subst
hilvanar algo (ideas, frases)<br/>hilvanar algo (text.)|etw. entwerfen<br/>etw. heften|Verb
hinchado/-a|aufgedunsen, geschwollen|Adj
el hinojo (bot.)<br/>hinojo hediondo (bot.)<br/>ponerse de hinojos|der Dill<br/>der Fenchel<br/>sich hinknien|Subst, Verb
la hojalata|das Blech|Subst
honrado/-a|ehrbar, grundehrlich, anständig|Adj
la hortaliza|grünes Gemüse, Frühgemüse|Subst
hosco/-a|mürrisch|Adj
el hoyo|das Loch, die Grupe, das Grab|Subst
husmear algo|etw. schnüffeln, etw. schnuppern|Verb
idóneo/-a|geeignet|Adj
igualar|gleich sein|Verb
ilícito/-a|unerlaubt, ungültig, unbefugt|Adj
ilógico/-a|unlogisch, widersinning|Adj
el impedimento|das Hindernis, der Hinderungsgrund|Subst
impeler algo<br/>impeler a alguien a algo|etw. fortschieben<br/>jmdn. zu etw. anregen, jmdn. zu etw. veranlassen|Verb
imperecedero/-a|unvergänglich|Adj
imperioso/-a|dringend|Adj
impetuoso/-a|heftig, ungestüm|Adj
impregnar algo|etw. durchtränken, etw. imprägnieren|Verb
impune|ungeahndet, straflos|Adj
inadvertido/-a|unauffällig, unbeachtet, unbemerkt|Adj
inamovible|unverrückbar, unversetzbar|Adj
la incertidumbre|die Ungewissheit, die Unklarheit, die Unsicherheit|Subst
el incidente|der Zwischenfall, der Vorfall|Subst
incipiente|einsetzend, beginnend|Adj
la incisión|der Schnitt, der Einschnitt|Subst
inconmensurable|unermesslich|Adj
indagar algo|etw. erforschen, etw. ermitteln|Verb
indecente|unanständig, ungebührlich, unziemlich|Adj
la indicación|das Zeichen, der Fingerzeig, der Hinweis|Subst
indigestarse (comida)<br/>indigesto/-a|schwer im Magen liegen<br/>unverdaulich|Verb, Adj
la indigestión|die Magenverstimmung, die Verdauungsstörung|Subst
indudablemente|zweifellos|Adv
la inercia|die Trägheit|Subst
inerme|wehrlos|Adj
inerte|reglos, leblos|Adj
inexorable|unerbittlich, unweigerlich|Adj
inextricable|unentwirrbar, unlösbar, undurchdringlich, verwicket|Adj
infernal|höllisch, infernal|Adj
infestar algo/a alguien de algo<br/>infestar algo (fig. - lugar)|jmdn./etw. mit etw. infizieren<br/>etw. befallen|Verb
ínfimo/-a|klein und mickrig, läppisch|Adj
el infortunio|das Unglück, das Ungemach|Subst
la infusión|der Kräutertee, der Aufguss|Subst
ingeniar algo|sich etw. ausdenken, etw. erfinden|Verb
ingerir algo|etw. schlucken, etw. einnehmen|Verb
injustamente|fälschlich, zu Unrecht|Adv
inmemorial|uralt, seit jeher|Adj
inmundo/-a|schmutzig, unrein|Adj
insignificante|geringfügig, gleichgültig, unscheinbar|Adj
la insinuación|die Andeutung, die Anspielung|Subst
insípido/-a|abgeschmackt, schal, geschmacklos|Adj
insuperable|unübertrefflich, unüberwindlich|Adj
intacto/-a|heil, intakt, unberührt|Adj
intempestivo/-a|zur Unzeit, ungelegen|Adj
interceptar algo|etw. unterbrechen, etw. sperren, etw. aufhalten|Verb
interferir|stören, interferieren|Verb
la intromisión|die Einmischung|Subst
inusitado/-a|ungewöhnlich, unüblich|Adj
invariable|unveränderlich,, unverändert|Adj
la ipecacuana (bot.)|die Brechwurz|Subst
irradiar algo|etw. verstrahlen, etw. durchstrahlen|Verb
irremediable|unvermeidbar, nicht zu verhindern|Adj
irrisorio/-a|lachhaft, lächerlich|Adj
jalar algo (col.)|an etw. ziehen|Verb
la jaqueca (med.)|die Migräne|Subst
jarretar a alguien|jmdn. entnerven|Verb
el jitomate (Lat. Am.: Méx. )|die Tomate|Subst
el juego<br/>el juego - botones, ropa interior, etc.|das Spiel<br/>die Garnitur, das Set|Subst
el jumil (insecto)|ein wanzenähnliches Insekt|Subst
juntar algo|etw. verbinden, etw. zusammentragen, etw. vereinigen|Verb
lastimar a alguien|jmdn. verletzen|Verb
lastimero/-a|jämmerlich, erbärmlich|Adj
el latón|das Messing|Subst
el laurel|der Lorbeer|Subst
el lazo|die Schleife, die Verschlingung, das Lasso|Subst
la lechada|die Tünche, die Kalkmilch|Subst
la legua|die spanische Meile|Subst
la lejía|die Bleichlauge, die Lauge|Subst
las lentes (Lat. Am. )|die Brille|Subst
la levadura|die Hefe|Subst
la leña|das Brennholz, das Reisig|Subst
la libra (moneda)|das Pfund|Subst
librar algo/a alguien de algo|jmdn./etw. von etw. befreien, jmdn./etw. von etw. erlösen, retten|Verb
el lienzo|das Leinen|Subst
la limosna|die Spende, der Almosen|Subst
linchar a alguien|jmdn. lynchen|Verb
el llavero|der Schlüsselanhänger, der Schlüsselbund|Subst
el logro|der Erfolg, die Errungenschaft, die Leistung|Subst
la loseta|die Wandplatte, die Fliese|Subst
el lucero - estrella, mancha<br/>el lucero - mancha|der Stern<br/>die Blesse|Subst
la lucidez|die Deutlichkeit|Subst
la lujuria|die Lüsternheit, die Wollust|Subst
la lumbre|die Flamme, die Glut|Subst
machacar algo|auf etw. einschlagen, etw. zerstampfen, etw. zerquetschen|Verb
macilento/-a|abgezehrt, fahl, hager|Adj
el maguey (Lat. Am.: Méx. ) (bot.)|die Agave|Subst
la maleza|das Unkraut, das Unterholz, das Buschwerk|Subst
maloliente|stinkend|Adj
el malvavisco (bot.)|Echter Eibisch|Subst
el mandato|die Amtzeit, das Mandat, der Befehl|Subst
manejar algo/a alguien<br/>manejarse|mit jmdm./etw. umgehen, etw. handhaben<br/>zurechtkommen, sich zu helfen wissen|Verb
el manicomio|die Irrenanstalt|Subst
la manta|die Schlafdecke, die Stalldecke|Subst
marchitarse (fig.)|ermatten, welk werden|Verb
mascullar algo|etw. murmeln, etw. nuscheln|Verb
el matón|der Schläger, der Raufbold|Subst
el mazo|der Stampfer, der Stößel|Subst
melindroso/-a|zimperlich, geziert|Adj
menear algo<br/>menearse|etw. schwenken, etw. schütteln<br/>wackeln|Verb
menso/-a|dumm, einfältig|Adj
mentar algo/a alguien|jmdn./etw. erwähnen, jmdn./etw. nennen|Verb
mentar algo<br/>mentado/-a|etw. erwähnen<br/>berühmt|Adj
meramente|bloß, lediglich|Adv
merecedor/-a|verdienstlich, wert, würdig|Adj
mero/-a|rein, einfach|Adj
el metate|die Reibmühle|Subst
mezquino/-a|geizig, dürftig|Adj
la miga<br/>migar algo|der Brösel, der Krümmel<br/>etw. zerbröseln|Subst, Verb
el minio (bau.)|die Mennige|Subst
el mirón|der Gaffer, der Spanner|Subst
mitigar algo|etw. abschwächen, mildern, lindern|Verb
el molcajete (Lat. Am.: Méx. )|der Mörser|Subst
moldear algo|etw. ausformen|Verb
la mole (corpulencia - persona)<br/>la mole (masa)|großer Umfang, massige Gestalt<br/>die Masse|Subst
molido/-a|gemahlen|Adj
la mollera (ugs.)|der Grips, der Verstand|Subst
morboso/-a|ungesund, krankhaft<br/>auf etw. heiß sein, auf etw. scharf sein|Adj
mordisquear algo|etw. anknabbern, etw. abknabbern|Verb
el mote|der Spitzname, die Devise, das Motto|Subst
mudo/-a|stumm|Adj
mutuo/-a|beiderseitig, gegenseitig|Adj
la nalgada|auf den Hintern, Glücksklaps auf den Arsch|Subst
la náusea|der Brechreiz|Subst
nefasto/-a|unglückbringend, unheilvoll|Adj
neto/-a<br/>neto/-a|klar, eindeutig<br/>netto|Adj
el nitro|der Salpeter|Subst
níveo/-a|blütenweiß|Adj
la noción|die Idee, der Begriff, die Vorstellung|Subst
la nodriza|die Amme|Subst
nogada|Soße aus Walnüssen und Gewürzen, in der Fisch gekocht wird|Subst
nomás (Lat. Am.)|kaum, lediglich|Adv
el nombramiento|die Ernennung, die Nominierung|Subst
las nupcias<br/>nupcial|die Eheschließung<br/>hochzeitlich|Subst
la obediencia|der Gehorsam|Subst
ocurrente|einfallsreich|Adj
el ombligo|der Bauchnabel|Subst
opuesto/-a|entgegengesetzt, gegensätzlich|Adj
orear algo|etw. auslüften|Verb
originar algo|etw. verursachen, etw. herbeiführen|Verb
la orza|henkelloses Tongefäß für Honig, Marmelade und Konserve|Subst
la osadía|die Tollkühnheit, die Beherztheit, die Dreistigkeit|Subst
la paliza|die Tracht Prügel, die Schläge|Subst
palpar algo|etw. abfühlen, etw. betasten, etw. ertasten|Verb
palpitar (corazón)|klopfen, schlagen, pochen|Verb
la pantorrilla|die Wade|Subst
el papalote (Lat. Am.: Méx.)|der Papierdrachen|Subst
el paradero|der Aufenthaltsort, der Verbleib|Subst
la paraplejia|die Querschnittslähmung|Subst
el parentesco|die Verwandtschaft|Subst
el párpado (anat.)|das Augenlid|Subst
el párroco (rel.)|der Pfarrer|Subst
la parroquia (rel.)|die Kirchengemeinde, die Pfarrei|Subst
partir|abreisen, losgehen, losbrechen, zerbrechen|Verb
partir<br/>partir algo|losgehen, aufbrechen<br/>etw. auseinanderreißen, etw. zerbrechen, etw. klassifizieren, etw einteilen|Verb
el parto|die Geburt, die Entbindung|Subst
pasmado/-a|verblüfft, verdattert|Adj
pasmarse|sprachlos sein, verblüfft sein|Verb
patear|trampeln, (vor Wut) aufstampfen|Verb
el pañal|die Windel|Subst
pecaminoso/-a|sündhaft|Adj
peculiar|eigenartig, besonders, speziell|Adj
pedalear|in die Pedale treten, radeln|Verb
el peltre (chem.)|das Bleizinn|Subst
pendiente|hängend, unerledigt, schwebend|Adj
penoso/-a|mühsam, leidvoll|Adj
penúltimo/-a|vorletzter|Adj
el peón|der Hilfsarbeiter|Subst
percatarse de algo|sich etw. bewusst werden, etw. bemerken|Verb
el perdedor, la perdedora|der Versager, die Versagerin<br/>der Verlierer, die Verliererin|Subst
perecer|zugrunde gehen, ums Leben kommen|Verb
perpetuar algo<br/>perpetuarse|etw. verewigen, etw. aufrechterhalten<br/>fortbestehen, sich verewigen|Verb
perseguir algo/a alguien|jmdn./etw. verfolgen, jmdm./etw. nacheilen, jmdm./etw. nachschleichen|Verb
persignar algo/a alguien<br/>persignarse (rel.)|jmdn./etw. segnen<br/>sich bekreuzigen|Verb
pescar algo|etw. angeln, etw. fischen, etw. fangen|Verb
el pescuezo|das Genick|Subst
petrificado/-a|versteinert|Adj
el pezón|die Zitze, die Brustwarze|Subst
piadoso/-a|barmherzig, fromm|Adj
el pilluelo, la pilluela (col.)|der Schlingel, der Fratz|Subst
el piloncillo (Lat. Am.: Méx. )|der Zuckerhut|Subst
la plática|der Schwatz|Subst
platicar (Lat. Am. )|sich unterhalten, plaudern|Verb
el platón (Lat. am.)|die Schüssel|Subst
la polvareda|die Staubwolke|Subst
por doquier|überall, weit und breit|Adj
por enésima vez|zum x-ten Mal|Adj
el porrazo|der Keulenschlag|Subst
los portacuchillos|der Messerblock|Subst
posponer algo, postponer algo|etw. aufschieben, etw. verschieben, etw. zurückstellen|Verb
la postura|die Körperhaltung|Subst
prematuro/-a|vorzeitig, frühzeitig|Adj
premeditado/-a|vorsätzlich, vorbedacht, wissenlich|Adj
a premura|die Dringlichkeit|Subst
prender algo|etw. anmachen, etw. anstecken|Verb
preponderar<br/>preponderante|überwiegen, vorherrschen<br/>überwiegend, vorwiegend|Verb, Adj
presenciar algo|etw. (mit eigenen Augen) sehen, bei etw. dabei sein|Verb
presionar a alguien|auf jmdn. Druck ausüben|Verb
la prestidigitación|die Gauklerei, die Taschenspielerei|Subst
prestigiar algo/a alguien|jmdm./etw. Ansehen verleihen|Verb
pretextar algo|etw. als Vorwand gebrauchen, vorgeben|Verb
primerizo/-a|anfängerisch|Adj
el procedimiento|das Verfahren, die Methode|Subst
procurar hacer algo|versuchen, etwas zu tun|Verb
la proeza|das Bravourstück, die Meisterleistung|Subst
profanar algo|etw. entweihen, etw. schänden|Verb
profesar algo - profesión, religión, ...|etw. ausüben, sich zu etw. bekennen|Verb
el progenitor<br/>la progenitora|das Elternteil<br/>die Mutter|Subst
propenso/-a|anfällig|Adj
propinar algo a alguien (golpe, etc.)|jmdm. etw. versetzen|Verb
propinar algo a alguien (golpe, etc.)<br/>propinar algo a alguien (med.)|jmdm. etw. versetzen<br/>jmdm. etw. verabreichen|Verb
el propósito|die Absicht, der Vorsatz|Subst
protuberante|hervorragend|Adj
proveerse de algo|sich mit etw. ausrüsten, sich mit etw. versorgen|Verb
el puchero|der Eintopf|Subst
pudrirse|faulen, vermodern|Verb
pueril|jungenhaft, kindisch, naiv|Adj
la puntada|die Naht|Subst
el puño|die Faust|Subst
quebrantar algo (ley, obligación)|etw. brechen|Verb
quintuplicar|verfünffachen|Verb
la ráfaga (meteo.)|die Windbö, die Bö|Subst
la raíz (bot. , math.)<br/>la raíz (anat.)|die Wurzel<br/>die Zahnwurzel|Subst
la ralladura (kulin.)|der Raspel|Subst
raptar a alguie|jmdn. entführen, jmdn. verschleppen|Verb
rasguñar algo|etw. anritzen, etw. aufkratzen|Verb
el raso<br/>el raso (vestido)|das Ödland<br/>das Satin|Subst
la raspadura|die Raspelspäne, das Abschaben|Subst
raspar algo|etw. abkratzen, etw. abschaben|Verb
la reanudación|die Wiederaufnahme, der Neustart|Subst
reavivar algo/a alguien|jmdn./etw. wiederbeleben|Verb
la rebanada|die Brotscheibe, die Schnitte|Subst
el rebozo (textil.)|mexikanisches Kleidungsstück für Frauen, eine Art Tuch|Subst
el recado|die Botschaft, der Botengang, die Besorgung|Subst
recalcar algo|etw. unterstreichen, etw. bekräftigen, etw. betonen|Verb
la recámara|die Kleiderkammer, das Schlafzimmer (lat. am.)|Subst
recapacitar (algo)|etw. überdenken, an etw. zurückdenken|Verb
recargar algo|etw. (neu) laden, etw. aufladen, etw. nachladen|Verb
recíproco/-a|gegenseitig, beiderseiting, reziprok|Adj
recobrar algo|etw. wiedererlangen, etw. wiederbekommen|Verb
reconfortar a alguien|jmdn. trösten, jmdm. wieder Mut zusprechen|Verb
el recoveco|die Krümmung|Subst
refilón, mirar de refilón|schräg ansehen|Verb
refinar algo<br/>refinado/-a|etw. verfeinern, etw. veredeln<br/>raffiniert, kultiviert|Verb, Adj
la regadera<br/>la regadera (Lat. Am.: Méx.)|die Gießkanne<br/>die Dusche|Subst
el regaño<br/>regañar a alguien|die Schelte<br/>jmdn. ausschimpfen, jmdn. rügen|Subst, Verb
regodearse con algo|sich an etw. ergötzen|Verb
reinante|regierend|Adj
la relegación|die Abschiebung, die Verweisung|Subst
reluciente|strahlend, glänzend|Adj
la remembranza|das Rückbesinnen|Subst
remitirse a algo|sich auf etw. berufen|Verb
remoto/-a|fern, abgelegen, weit entfernt|Ad
la rendija|der Lichtspalt, der Spalt|Subst
renegar algo<br/>renegar de algo|etw. ableugnen<br/>etw. verfluchen, etw. abschwören|Verb
renunciar a algo|sich etw. verkneifen, etw. entsagen, etw. (sein) lassen|Verb
repelar|mähen, zausen, kahl scheren|Verb
repentino/-a|plötzlich, jäh, schlagartig|Adj
reposar|sich ausruhen, ruhen, schlafen|Verb
reprender a alguien|jmdn. tadeln, zurechtweisen|Verb
reprimir algo|sich etw. verkneifen, etw. zurückhalten|Verb
repugnante|abscheuerregend, Ekel erregend|Adj
la res|das Vieh|Subst
resbalar|abgleiten, abperlen, abrutschen|Verb
el residuo|das Abfallprodukt, der Rückstand|Subst
el resorte (tech.)|die Triebfeder, die Feder|Subst
el resplandor|der Lichtschein, der Lichschimmer|Subst
el resquemor|der Kummer|Subst
el resquicio|die Ritze|Subst
restablecerse<br/>restablecer algo|sich erholen<br/> etw. wiederherrichten, etw. wiederherstellen|Verb
restregar|etw. rubbeln, etw. scheuern|Verb
el retazo|der Rest, das Stück|Subst
retorcer algo|etw. krümmen, etw. winden, etw. verdrehen|Verb
retorcido/-a|gekrümmt, verdreht|Adj
el retorno|die Rückkehr|Subst
reunir algo<br/>reunir algo/a alguien|etw. ansammeln, etw. zusammensuchen<br/> jmdn./etw. vereinen, jmdn./etw. zusammenführen|Verb
revelar algo|etw. enthüllen, etw. offenlegen|Verb
reverendo/-a|ehrwürdig|Adj
revolcar algo/a alguien|jmdn./etw. zu Boden werfen, jmdn./etw. zu Fall bringen|Verb
rezar|beten|Verb
el rezo<br/>rezar|das Gebet<br/>beten|Subst, Verb
el riachuelo|das Flüsschen, das Bächlein|Subst
el rictus|der Gesichtsausdruck, das Zwangslachen|Subst
la rienda|der Zügel|Subst
el roce<br/>rozar algo/a alguien|die Reibung<br/>jmdn./etw. leicht berühren, jmdn./etw. streifen|Subst
rociar algo con algo|etw. mit etw. besprengen, etw. mit etw. bestreuen, etw. mit etw. benetzen|Verb
el rocío (meteo.)|der Tau|Subst
rodar|rollen, kullern|Verb
el ropero|der Kleiderschrank, der Kleiderhändler|Subst
la roseta|das Röschen, der Puffmais|Subst
rotundo/-a|kategorisch, rundweg|Adj
rozagante|stolz, ansehlich, prächtig|Adj
rozar algo/a alguien|jmdn./etw. leicht berühren, jmdn./etw. streifen|Verb
el rubor|die Röte|Subst
el ruego<br/>rogar algo|die Bitte<br/>etw. erbitten|Subst, Verb
sacar algo a colación|etw. anführen, etw. zur Sprache bringen|Verb
sacudir algo/a alguien|jmdn./etw. durchrütteln, jmdn./etw. schütteln|Verb
salar algo (kulin.)|etw. salzen, etw. versalzen|Verb
la sanguijuela|der Blutegel|Subst
la sazón|die Reife, die Würze|Subst
sazonar algo<br/>sazonar algo (kulin.)|etw. reifen lassen<br/>etw. abschmecken, etw. würzen|Verb
sazonarse<br/>sazonar algo|reifen<br/>etw. reifen lassen, etw. abschmecken, etw. würzen|Verb
sellar algo|etw. stempeln, etw. siegeln|Verb
el semblante|die Miene, der Gesichtsausdruck|Subst
semejante|solcher, derart|Adj
semental|Saat..., Zucht...|Adj
la senectud|das Greisenalter|Subst
sensual|sinnlich|Adj
sentenciar algo<br/>sentenciar a alguien a algo|etw. entscheiden, etw. zu Protokoll geben<br/>jmdn. zu etw. verurteilen|Verb
la serenidad|die Gelassenheit, die Abgeklärtheit|Subst
sereno/-a|heiter, ruhig, gelassen|Adj
severo/-a|streng, schwerwiegend|Adj
las señas|die Anschrift|Subst
la sien (anat.)|die Schläfe|Subst
el sino|das Schicksal, das Verhängnis|Subst
soberano/-a|eigenstaatlich, souverän|Adj
soberano/-a<br/>una soberana paliza|souverän<br/>eine ordentliche Tracht Prügel|Adj, Phrase
sobrecogedor/-a|überraschend, überwältigend|Adj
sobresalir|herausstehen, hervorragen|Verb
sometido/-a|unterworfen, zensiert|Adj
sonrosado/-a|rosenfarbig, rosig|Adj
el sordomudo, la sordomuda|der Gehörlose, die Gehörlose<br/>der Taubstumme, die Taubstumme|Subst
el sortilegio|die Hexerei, die Zauberei|Subst
el subterfugio|die Ausflucht, die Ausrede, der Vorwand|Subst
suculento/-a|saftig|Adj
la sugerencia|der Tipp, der Vorschlag, die Anregung|Subst
el sujeto|der Mensch, das Ding, die Person|Subst
supremo/-a|allerhöchst|Adj
el surco|die Ackerfurche, die Furche, die Falte|Subst
suscitar algo|etw. hervorrufen, etw. auslösen, etw. erregen|Verb
sutil|feinsinnig, subtil|Adj
la tablilla|das Armtragetuch, das Täfelchen, das Brettchen|Subst
el tablón|die Hinweistafel, das Brett|Subst
el tajo<br/>el tajo de la cocina<br/>tajar algo|das Holzklötzchen, der Schnitt<br/>des Schneidebrett<br/>etw. schneiden|Subst, Verb
taladrar algo (tech.)|etw. durchbohren|Verb
el tamiz|das Filtersieb, das Sieb|Subst
tamizado/-a|gesiebt, überprüft|Adj
el tapujo<br/>el tapujo (col.)|die Vermummung<br/>die Verheimlichung, die Verhüllung|Subst
la tela|der Stoff, das Leintuch|Subst
la telera (Lat. Am.: Méx. )|das Brot|Subst
el temor|die Furcht, die Bange|Subst
templar algo|etw. abschwächen, etw. mildern, etw. dämpfen|Verb
tenso/-a|straff, spannend, angespannt|Adj
tenue|dünn, fein, zart|Adj
el tepezcuintle (Lat. Am., zool.)|das Paka|Subst
el testículo|der Hoden|Subst
a tientas<br/>tentar algo/a alguien|blindlings<br/>jmdn./etw. betasten|Adj, Verb
la tina|die Wanne, der Zuber|Subst
la tinaja|der Tonkrug|Subst
la tiniebla|die Finsternis|Subst
el tino|die Geschicklichkeit, die Treffsicherheit|Subst
la tira|das Band, der Streifen|Subst
el tizón|der Getreidebrand, die Kohle|Subst
el tomillo|der Thymian|Subst
el tornasol|das Changieren|Subst
torpe|schwerfällig, ungeschickt|Adj
el torrente|der Sturzbach, der Schwall|Subst
tostar algo (kulin.) -pan<br/>tostarse|etw. toasten<br/>sich bräunen|Verb
la tranca<br/>la tranca - de la puerta|der Knüppel<br/>der Türriegel|Subst
el trance|die Trance, schwierige Situation, kritische Lage|Subst
transmutar algo en algo|etw. in etw. umwandeln, etw. in etw. verwandeln|Verb
el traste (Lat.Am)|das Gerümpel, der Kram|Subst
el traste<br/>los trastes (lat. am.)|der Gittarenbund<br/>der Kram, das Gerümpel<br/>das Geschirr|Subst
el trebejo|das Gerät, das Handwerkzeug|Subst
la trementina|das Terpentin|Subst
el trigo (bot.)|der Weizen|Subst
las tripas(kulin.)<br/>la tripa (anat.)|die Kutteln<br/>der Darm|Subst
los triques (Lat. Am.: Méx., col.)|der Krimskrams|Subst
tronar (meteo.)|donnern|Verb
el tropel<br/>el tropel (prisa)|das Durcheinander, das Wirrwarr, das Getümmel<br/>die Eile, die Hast|Subst
el tueste|das Rösten|Subst
la turbación|die Bestürzung, die Verwirrung|Subst
untar algo|etw. einreiben|Verb
la urbanidad|die Höflichkeit|Subst
la utilidad|der Nutzen, die Verwendungsmöglichkeit|Subst
vagar|herumbummeln, umherstreifen|Verb
la vajilla|das Essgeschirr|Subst
vanamente|abergläubisch, grundlos, selbstgefällig, vergeblich|Adv
la vanidad|die Eitelkeit, die Selbstzufriedenheit|Subst
vano/-a|vergeblich, unbegründet|Adj
el varón|der (junge) Kerl|Subst
varonil|männlich|Adj
vedar algo|etw. verbieten, etw. hemmen, etw. untersagen|Verb
la vejez|die Betagtheit, der Lebensabend|Subst
la velada|der Abend, die Nachtwache, die Abendveranstaltung|Subst
velar algo/a alguien|jmdn./etw. bewachen, etw. verschleiern|Verb
el velorio|die Totenwache|Subst
vestido de encajes|das Spitzenkleid|Subst
vetar algo|gegen etw. ein Veto einlegen|Verb
el vientre|der Bauch, der Unterleib|Subst
la virtud|die Fähigkeit, die Tugend|Subst
las vísceras|die Eingeweide|Subst
la víspera|der Vorabend, der Vortag|Subst
el vitral|das Kirchenfenster|Subst
la vivacidad|die Aufgewecktheit, die Lebendigkeit, die Lebhaftigkeit|Subst
voluntario/-a|freiwillig|Adv
voluptuoso/-a|wollüstig|Adj
la voluta|das Schneckengehäuse, die Spirale|Subst
la voracidad|die Gefräßigkeit|Subst
vulgar|vulgär, ordinär|Adj
la yema|der Eidotter, das Eigelb|Subst
la yesca|der Zunder|Subst
la zancada|langer Schritt|Subst
